共搜索到词条111个:
Caigiya Hala	蔡佳氏 
Cai Hala	蔡氏 
Canggiya Hala	仓佳氏 
Cangmajir Hala	苍马尔纪氏 
Caogiya Hala	曹佳氏 
Cao Hala	曹氏 
Cao Hala	曹氏 
Caodan Hala	漕丹氏 
Calala Hala	查喇拉氏 
Caodan Hala	察哈尔氏 
Cakcin Hala	察克钦氏 
Calagolo Hala	察喇觉罗氏 
Cai Hala	柴氏 
Canggiya Hala	常佳氏 
Ce Hala	车氏 
Cemgun Hala	彻穆衮氏 
Ceyele Hala	彻叶勒氏 
Cengiya Hala	陈佳氏 
Cen Hala	陈氏 
Cen Hala	陈氏 
Cenggiya Hala	成佳氏 
Cenggi Hala	成尼氏 
Ceng Hala	程氏 
Cengkiyir Hala	橙气依尔氏 
C’ygiya Hala	迟佳氏 
C’ygiya Hala	持嘉氏 
Cogolu Hala	崇果噜氏 
Cojila Hala	崇吉喇氏 
Cukule Hala	楚库勒氏 
Coki Hala	绰克秦氏 
Colo	绰罗氏 
Colosi Hala	绰罗斯氏 
Cuigiya Hala	崔佳氏 
Cuimulu Hala	崔穆鲁氏 
Cui Hala	崔氏 
Cui Hala	崔氏 
Cuijuke Hala	崔珠克氏 
Ci Hala	戚氏 
Ci Hala	祁氏 
Cibgio Hala	齐步樵氏 
Cidal Hala	齐达勒氏 
Cirbsu Hala	齐尔博苏氏 
Cigiya Hala	齐佳氏 
Cikten Hala	齐克腾氏 
Cimo Hala	齐墨氏 
Cimsi Hala	齐墨斯氏 
Cimte Hala	齐默特氏 
Cimketu Hala	齐木克图氏 
Cimke Hala	齐穆克氏 
Cipunute Hala	齐普楚特氏 
Cipucite Hala	齐普齐特氏 
Cipucinute Hala	齐普钦努特氏 
Ciyegamte Hala	齐岳噶穆特氏 
Cideri Hala	奇德哩氏 
Cidumu Hala	奇杜穆氏 
Cirgote Hala	奇尔果特氏 
Cilei Hala	奇垒氏 
Cileng Hala	奇楞氏 
Citela Hala	奇塔喇氏 
Ciyala Hala	恰喇氏 
Ciyate Hala	洽特氏 
Ciangiya Hala	钱佳氏 
Cian Hala	钱氏 
Ciyarya Hala	强尔雅氏 
Ciyahiri Hala	强恰理氏 
Ciya Hala	强氏 
Ciaogiya Hala	乔佳氏 
Ciao Hala	乔氏 
Cin Hala	秦氏 
Cingeri Hala	庆格哩氏 
Ciog Hala	邱氏 
Ciogiya Hala	秋佳氏 
Ciog Hala	秋氏 
Ciosuri Hala	秋舒哩氏 
Ciu Hala	曲氏 
Ciugiya Hala	屈佳氏 
Ciu Hala	屈氏 
Ciwangiya Hala	全佳氏 
Cibsen　　　　　　　　齐布琛　　　　　　　 静　 
Cibsonggo　　　　　　 齐布松敖　　　　　　 昭穆之昭　 
Colgoroko　　　　　　 绰勒果罗科　　　　　 超出、超群　 
Colgorokobi　　　　　 绰勒果罗科比　　　　 超群　 
Colhorokongge　　　　 绰勒和罗孔额　　　　 出类的、超群的　 
NamuCoko　　　　　　　纳穆绰科　　　　　　 孔雀　 
Cagan　　　　　　　　 察干　　　　　　　　 书籍　 
Caida　　　　　　　　 柴达　　　　　　　　 茶卤　 
Canggadai　　　　　　 常阿岱　　　　　　　 钲　 
Carki　　　　　　　　 察尔奇　　　　　　　 楂板　 
Ceke　　　　　　　　　车克　　　　　　　　 稍儿　 
Centai　　　　　　　　陈泰　　　　　　　　 微尘　 
Cihala　　　　　　　　戚哈喇　　　　　　　 嗜好　 
Colhon　　　　　　　　绰罗欢　　　　　　　 山峰　 
Coki　　　　　　　　　绰奇　　　　　　　　 前奔颅　 
Coohar　　　　　　　　超哈尔　　　　　　　 兵，武　 
CukuBaturu　　　　　　褚库巴图鲁　　　　　 抬起勇士　 
Mini gebu be Cang Gui sembi	我的名字叫长贵。 
Cananggi jimbi seme ainu jihekv? 前日说来为什么没来？ 
Cananggi de jabduhakv	前日没得功夫。 
Cai omireo	Ume dambaku gocire	请喝茶。请勿吸烟。 
[agvra] 道具,機械 
[cecerecuke] 怒る,腹を立てる,機嫌が悪い,になりやすい 
[yasai hvntahan] 目の周りの窪み,眼窩 
[largin] 煩雑な,錯綜した 
[nashvn] 機会,縁 
[nergin de] の際に,の機会に 
[tehe] 棒の一種,機織り器,台,羊の一種 
[tuwancihiya-] 矯正する,直す,正す,馬を操る 
[ucuri] 機会,際,折 
Cai omiki 请用茶 [来源 http://sihvsurehan.blog.sohu.com] 
Cihalan i oki 请随意 [来源 http://sihvsurehan.blog.sohu.com] 
刑部 损人二事以上笃疾癈疾 niyalmai juwe ba ci wesihun efulere, uju efebuhe eden dadun 坏伤口鼻等之处或手足致二处或多以致其人成重疾或癈疾不能作事者 满文 