共搜索到词条1432个:
Feigiya Hala	费佳氏 
Feimo Hala	费莫氏 
Fei Hala	费氏 
Fiya Hala	费雅氏 
Feiyanggu Hala	费仰古氏 
Fenggiya Hala	丰佳氏 
Fengeri Hala	冯额礼氏 
Feng Hala	冯氏 
Feduokimri Hala	佛多锡墨理氏 
Futa Hala	福塔氏 
Fusi Hala	福锡氏 
Furha Hala	付特哈氏 
Fugiya Hala	傅佳氏 
Fu Hala	傅氏 
Fu Hala	傅氏 
Fuciri Hala	傅锡哩氏 
Fuca Hala	富察氏 
Fulkulu Hala	富尔库鲁氏 
Furca Hala	富勒察氏 
Fulehu Hala	富勒瑚氏 
Fuseri Hala	富色勒氏 
Fuse Hala	富森氏 
Fsuku Hala	富思库氏 
Fusuhu Hala	富苏瑚氏 
Fuye Hala	富义氏 
Fujuri Hala	富珠理氏 
Gabaga Hala	噶巴喀氏 
Gabihik Hala	噶必齐克氏 
Gargasi Hala	噶尔噶斯氏 
Garu Hala	噶努氏 
Gangiya Hala	甘佳氏 
Gang Hala	冈氏 
Gang Hala	刚氏 
Gonggite Hala	高达玛氏 
Gaogiya Hala	高佳氏 
Gao Hala	高氏 
Gergi Hala	格尔齐氏 
Gege Hala	格格氏 
Gejile Hala	格济勒氏 
Gegiyala Hala	格佳喇氏 
Gejun Hala	格晋氏 
Gerungioro Hala	格伦觉罗氏 
Gelole Hala	格罗勒氏 
Gerke Hala	葛尔克氏 
Gewayir Hala	葛瓦依尔氏 
Geyikel Hala	葛依克勒氏 
Gejele Hala	葛哲勒氏 
Geng Hala	耿氏 
Geng Hala	耿氏 
Genggitungga Hala	耿音氏 
Gungeri Hala	公鄂哩氏 
Gonggite Hala	公吉尔氏 
Gonggilate Hala	公吉喇特氏 
Gonggite Hala	公吉特氏 
Hancuha Hala	罕楚哈氏 
Hancu Hala	罕楚氏 
Hangilajin Hala	罕吉拉锦氏 
Hanja Hala	罕扎氏 
Hanyan Hala	翰颜氏 
Hanggatan Hala	杭噶坦氏 
：Hanggiya Hala	杭佳氏 
Hanggin Hala	杭津氏 
Hao Hala	郝氏 
Helagio Hala	何拉觉氏 
Helteyir Hala	何勒特依尔氏 
He Hala	何氏 
He Hala	何氏 
Herci Hala	和尔钦氏 
Her Hala	和尔氏 
Heheci Hala	和和齐氏 
Helgote Hala	和脱果特氏 
Heyuelo Hala	和岳罗氏 
Heyer Hala	荷叶尔氏 
Hejair Hala	贺在尔氏 
Hergin Hala	赫尔济氏 
Hernuoloyasu Hala	赫尔诺络雅苏氏 
Heru Hala	赫尔氏 
Hersu Hala	赫尔苏氏 
Hegiri Hala	赫济哩氏 
Hegiya Hala	赫佳氏 
Hele Hala	赫勒氏 
Heruk Hala	赫鲁克氏 
Hecila Hala	赫齐拉氏 
Heseri Hala	赫舍里氏 
Hesu Hala	赫书氏 
Hesuri Hala	赫舒哩氏 
Hehiheri Hala	赫锡赫理氏 
Hehite Hala	赫锡特氏 
Heyel Hala	赫叶勒氏 
Heye Hala	赫宜氏 
Heje Hala	赫哲氏 
Heihemu Hala	黑赫穆氏 
Hengkile Hala	亨奇勒氏 
Henggiri Hala	恒吉哩氏 
Hengtai Hala	恒泰氏 
Hengtai Hala	恒泰氏 
Heng Hala	衡氏 
Hongyi Hala	宏义氏 
Hongdari Hala	洪达哩氏 
Hongecun Hala	洪鄂春氏 
Hongecuo Hala	洪鄂绰氏 
Hongelote Hala	洪鄂罗特氏 
Gungyiri Hala	公仪理氏 
Gonggite Hala	功格喇布氏 
Gunggiya Hala	恭佳氏 
Gon Hala	龚氏 
Gon Hala	巩氏 
Gulgi Hala	古尔吉氏 
Gulayir Hala	古拉依尔氏 
Gu Hala	顾氏 
Guuwalgiya Hala	瓜尔佳氏 
Guuwagi Hala	瓜吉氏 
Guuwalca Hala	卦勒察氏 
Guangiya Hala	官佳氏 
Guanggiya Hala	广佳氏 
Guwecite Hala	贵车特氏 
Guweyueri Hala	贵岳哩氏 
Gobeir Hala	郭贝尔氏 
Golbon Hala	郭尔本氏 
Gorgiya Hala	郭尔佳氏 
Gorlos Hala	郭尔罗斯氏 
Gorlote Hala	郭尔罗特氏 
Gohun Hala	郭珲氏 
Gogiya Hala	郭佳氏 
Gololo Hala	郭罗罗氏 
Gurun Hala	郭罗氏 
Gociri Hala	郭齐里氏 
Go Hala	郭氏 
Go Hala	郭氏 
Gowur Hala	郭武尔氏 
Gorgi Hala	果尔吉氏 
Haba Hala	哈巴氏 
Harca Hala	哈尔察氏 
Harhagioro Hala	哈尔哈觉罗氏 
Harginu Hala	哈尔吉努氏 
Harginote Hala	哈尔吉诺特氏 
Hargi Hala	哈尔吉氏 
Harla Hala	哈尔拉氏 
Her Hala	哈尔图特氏 
Haher Hala	哈赫尔氏 
Harbin Hala	哈勒斌氏 
Halcitate Hala	哈勒齐塔特氏 
Haltala Hala	哈勒塔喇氏 
Harite Hala	哈哩特氏 
Her Hala	哈纳克氏 
Hasala Hala	哈萨喇氏 
Hacihuri Hala	哈思呼哩氏 
Hasha Hala	哈思琥氏 
Hasiri Hala	哈苏哩氏 
Hasite Hala	哈苏特氏 
Haigiya Hala	海佳氏 
Hairasu Hala	海拉苏氏 
Hanrgiya Hala	韩尔佳氏 
Hangiya Hala	韩佳氏 
Han Hala	韩氏 
Han Hala	韩氏 
Arla Hala	阿尔拉氏 
Artasi Hala	阿尔塔斯氏 
Ahagolo Hala	阿哈觉罗氏 
Akjan Hala	阿克占氏 
Alabinkin Hala	阿拉边前氏 
Aiar Hala	阿拉尔氏 
Aiakcou Hala	阿拉克球氏 
Alakta Hala	阿拉克塔氏 
Aia Hala	阿喇氏 
Alan Hala	阿赉氏 
Albaki Hala	阿勒巴齐氏 
Alban Hala	阿勒班氏 
Altanemoke Hala	阿勒坦鄂谟克氏 
Alte Hala	阿勒特氏 
Alha Hala	阿礼哈氏 
Alu Hala	阿噜氏 
Alulote Hala	阿鲁络特氏 
Alute Hala	阿鲁特氏 
Amharnu Hala	阿穆哈尔努氏 
Amila Hala	阿穆拉氏 
Amlu Hala	阿穆噜氏 
Amuniputasi Hala	阿穆尼普塔斯氏 
Acigecayie Hala	阿其格查依尔氏 
Asuke Hala	阿苏克氏 
Asu Hala	阿苏氏 
Atamu Hala	阿塔穆氏 
Atulmu Hala	阿图拉墨氏 
Ayangoro Hala	阿颜觉罗氏 
Ayantatan Hala	阿颜塔塔尔氏 
Aiyaosi Hala	艾耀施氏 
Aiman Hala	爱满氏 
Aisingoro Hala	爱新觉罗氏 
aiyi Hala	爱义氏 
Aihun Hala	瑷珲氏 
Andala Hala	安达拉氏 
Angiya Hala	安佳氏 
Aocen Hala	敖辰氏 
：Aogiya Hala	敖佳氏 
Ela Hala	敖拉氏 
Elatokin Hala	敖拉托欣氏 
Elador Hala	敖勒多尔氏 
Barda Hala	巴尔达氏 
Barla Hala	巴尔拉氏 
Bagiri Hala	巴济哩氏 
Baksang Hala	巴克桑氏 
Bari Hala	巴哩氏 
Balikagir Hala	巴力卡吉尔氏 
Bari Hala	巴林氏 
Balute Hala	巴鲁特氏 
Basun Hala	巴逊氏 
Bayalhi Hala	巴雅尔齐氏 
Bayara Hala	巴雅尔氏 
Burhaci Hala	巴雅克氏 
Sungyan Hala	松颜氏 
Sunggiya Hala	嵩佳氏 
Sung Hala	宋氏 
Sung Hala	宋氏 
Surgiya Hala	苏尔佳氏 
Sugiya Hala	苏佳氏 
Sukca Hala	苏克察氏 
Sulala Hala	苏拉喇氏 
Sumil Hala	苏密尔氏 
Sumuk Hala	苏木克氏 
Sumca Hala	苏穆察氏 
Sunite Hala	苏尼特氏 
Su Hala	苏氏 
Suigiya Hala	随佳氏 
Sugiya Hala	孙佳氏 
Sungin Hala	孙津氏 
Sunniyaote Hala	孙尼耀特氏 
Sun Hala	孙氏 
Sun Hala	孙氏 
Suncor Hala	荪绰尔氏 
Socala Hala	索察喇氏 
Soca Hala	索察氏 
Soceri Hala	索彻哩氏 
Socor Hala	索绰尔氏 
Socolo Hala	索绰罗氏 
Sorduo Hala	索尔多氏 
Sorgi Hala	索尔济氏 
Sogiyala Hala	索济雅喇氏 
Sogiya Hala	索佳氏 
Solongusi Hala	索龙古斯氏 
Solongal Hala	索罗噶尔氏 
Soloncia Hala	索罗恰氏 
Sonotu Hala	索诺图氏 
Socile Hala	索齐勒氏 
Tabenutuk Hala	塔本努图克氏 
Socagiorca Hala	塔察觉尔察氏 
Talhunute Hala	塔尔瑚努特氏 
Talbacik Hala	塔喇巴齐克氏 
Tala Hala	塔喇氏 
Tamca Hala	塔穆察氏 
Tatar Hala	塔塔儿氏 
Tatala Hala	塔塔喇氏 
Tatan Hala	塔坦氏 
Taicu Hala	台楚氏 
Taicuru Hala	泰楚鲁氏 
Taicute Hala	泰楚特氏 
Taihute Hala	泰瑚特氏 
Taihinala Hala	泰锡纳喇氏 
Tan Hala	谈氏 
Tanmca Hala	谭木查氏 
Tan Hala	谭氏 
Tankai Hala	坦开氏 
Tang Hala	汤氏 
Tangwu Hala	汤务氏 
Tangda Hala	唐达氏 
Tanggul Hala	唐古尔氏 
Tanggu Hala	唐古氏 
Tanggute Hala	唐古特氏 
Tanggiya Hala	唐佳氏 
Tangni Hala	唐尼氏 
Tang Hala	唐氏 
Tangyan Hala	唐颜氏 
Taogiya Hala	陶佳氏 
Tao Hala	陶氏 
Tergil Hala	特尔吉尔氏 
Taigi Hala	特济氏 
Tiangiya Hala	田佳氏 
Tian Hala	田氏 
Tian Hala	田氏 
Te Hala	铁氏 
Tongala Hala	通阿拉氏 
Tonggosu Hala	通果苏氏 
Tongyangiolo Hala	通颜觉罗氏 
Tongelo Hala	佟鄂络氏 
Donggiya Hala	佟佳氏 
Tongniyaote Hala	佟尼耀特氏 
Tunggi Hala	佟启氏 
Tungsail Hala	佟赛勒氏 
Tong Hala	佟氏 
Tong Hala	佟氏 
Tubote Hala	图伯特氏 
Turdun Hala	图尔敦氏 
Turgen Hala	图尔格氏 
Turgiya Hala	图尔佳氏 
Turtala Hala	图尔塔喇氏 
Tugiya Hala	图佳氏 
Tukdun Hala	图克敦氏 
Tukcinala Hala	图克齐纳喇氏 
Tukdan Hala	图克坦氏 
Tuleri Hala	图勒哩氏 
Tulolute Hala	图罗鲁特氏 
Tumen Hala	图们氏 
Tupusu Hala	图普苏氏 
Tusala Hala	图萨喇氏 
Tuseri Hala	图色哩氏 
Tu Hala	图氏 
Tu Hala	屠氏 
Tumte Hala	土默特氏 
Toherci Hala	托和尔秦氏 
Tohoro Hala	托和罗氏 
Tolgiya Hala	托勒佳氏 
Toli Hala	托里氏 
Tolote Hala	托罗特氏 
Tomon Hala	托谟氏 
Totek Hala	托忒克氏 
Wargi Hala	瓦尔吉氏 
Warke Hala	瓦尔喀氏 
Wala Hala	瓦兰氏 
Walgiya Hala	瓦勒佳氏 
Wari Hala	瓦哩氏 
Wamo Hala	瓦墨氏 
Wase Hala	瓦色氏 
Wa Hala	瓦氏 
Wanyan Hala	完颜氏 
Wanlioha Hala	万旒哈氏 
Wan Hala	万氏 
Wan Hala	万氏 
Wanggiya Hala	汪佳氏 
Wang Hala	汪氏 
Wangjabu Hala	汪扎布氏 
Wang Hala	王氏 
Wanggulcin Hala	旺古尔沁氏 
Wanggi Hala	旺吉氏 
Wangsute Hala	旺舒特氏 
Wangjal Hala	旺扎尔氏 
Weigiya Hala	魏佳氏 
Weilayir Hala	魏拉依尔氏 
Wei Hala	魏氏 
Wenca Hala	温察氏 
Wenceheng Hala	温彻亨氏 
Wendenge Hala	温登额氏 
Wendu Hala	温都氏 
Wentehe Hala	温特赫氏 
Wentun Hala	温屯氏 
Wenda Hala	文达氏 
Wende Hala	文德氏 
Wen Hala	文氏 
Wenja Hala	文札氏 
Wen Hala	闻氏 
Wengari Hala	翁阿里氏 
Wenggori Hala	翁郭里氏 
Wenggote Hala	翁果特氏 
Wenggilgin Hala	翁吉勒金氏 
Wenggite Hala	翁吉特氏 
Wengkete Hala	翁科特氏 
Wengniri Hala	翁尼哩氏 
Wengnite Hala	翁尼特氏 
Wengnote Hala	翁牛特氏 
Wengniolo Hala	翁钮络氏 
Wengsejan Hala	翁舍占氏 
Wecehe Hala	倭彻赫氏 
Weceku Hala	倭彻库氏 
Wecele Hala	倭彻勒氏 
Wehe Hala	倭赫氏 
Wese Hala	沃色氏 
Wle Hala	斡勒氏 
Ucala Hala	乌察喇氏 
Urda Hala	乌尔达氏 
Urgucen Hala	乌尔古宸氏 
Urhan Hala	乌尔汉氏 
Wlhanga Hala	乌尔杭阿氏 
Urhugi Hala	乌尔瑚济氏 
Ugicite Hala	乌济奇特氏 
Ula Hala	乌拉氏 
Ulatehake Hala	乌喇特哈克氏 
U Hala	乌喇特氏 
Wlan Hala	乌兰氏 
Ulanghate Hala	乌朗哈特氏 
Ulate Hala	乌勒理氏 
Usuri Hala	乌礼苏氏 
Wligin Hala	乌里津氏 
Wliyate Hala	乌里雅特氏 
Wlite Hala	乌理特氏 
Wlanghaigilmo Hala	乌梁海济勒默氏 
Wlin Hala	乌麟氏 
Uru Hala	乌噜氏 
Ulute Hala	乌鲁特氏 
Wmi Hala	乌密氏 
Wnate Hala	乌纳特氏 
Wnemul Hala	乌讷穆尔氏 
Uru Hala	乌努氏 
Wligin Hala	乌齐熙理氏 
Wligin Hala	乌齐喜特氏 
Wciyarkan Hala	乌恰尔坎氏 
Use Hala	乌色氏 
Usila Hala	乌什拉氏 
Usuri Hala	乌苏哩氏 
Usun Hala	乌苏氏 
Usujan Hala	乌苏占氏 
Uki Hala	乌锡氏 
Uyaca Hala	乌雅察氏 
Uyala Hala	乌雅拉氏 
Uya Hala	乌雅氏 
Uyanhi Hala	乌颜齐氏 
Uyu Hala	乌裕氏 
Ujaku Hala	乌扎库氏 
Ujala Hala	乌扎喇氏 
Ugigiyala Hala	吴济佳喇氏 
Ugitek Hala	吴济忒克氏 
Ugiya Hala	吴佳氏 
Wkeding Hala	吴克定氏 
Ukuri Hala	吴库理氏 
Ulehi Hala	吴勒锡氏 
Ulina Hala	吴灵阿氏 
Uluri Hala	吴鲁哩氏 
Umu Hala	吴穆氏 
Unuhu Hala	吴努呼氏 
Unuci Hala	吴努齐氏 
Uyan Hala	吴然氏 
U Hala	吴氏 
U Hala	吴氏 
Uja Hala	吴扎氏 
Ujalhu Hala	吴札勒瑚氏 
Wengari Hala	伍尧氏 
Urgeci Hala	武尔格齐氏 
Ugiya Hala	武佳氏 
Ukudenggi Hala	武库登吉氏 
Hifaci Hala	西法齐氏 
Hilingiolo Hala	西林觉罗氏 
Hiblu Hala	希卜鲁氏 
Hibsu Hala	希卜苏氏 
Hisala Hala	希萨尔氏 
Hirgiya Hala	奚尔佳氏 
Hiha Hala	奚哈氏 
Hirbi Hala	锡尔弼氏 
HirdeteHala	锡尔德特氏 
Hirha Hala	锡尔哈氏 
Hirtu Hala	锡尔图氏 
Hircin Hala	锡尔馨氏 
Hikca Hala	锡克德氏 
Hikgila Hala	锡克济拉氏 
Hikteri Hala	锡克特哩氏 
Hilade Hala	锡喇德氏 
Hilatu Hala	锡喇图氏 
Hilergi Hala	锡勒尔吉氏 
Hilin Hala	锡临氏 
Hiluke Hala	锡鲁克氏 
Himala Hala	锡玛喇氏 
Himole Hala	锡墨勒氏 
Hinaminga Hala	锡纳明安氏 
Hinecuke Hala	锡讷楚克氏 
Hinete Hala	锡讷特氏 
Hiciya Hala	锡强氏 
Hilute Hala	席鲁特氏 
Hicigil Hala	席奇吉尔氏 
Hitala Hala	喜塔腊氏 
Hitelna Hala	喜特勒那氏 
Hija Hala	喜瞻氏 
Hia Hala	夏氏 
Hiandacan Hala	贤达禅氏 
Hiang Hala	向氏 
Hiao Hala	萧氏 
Hiao Hala	肖氏 
Hie Hala	谢氏 
Hin Hala	辛氏 
Hin Hala	辛氏 
Hing Hala	邢氏 
Hinggiya Hala	性佳氏 
Hiyogiya Hala	休佳氏 
Hiyoheri Hala	修和哩氏 
Hiyomori Hala	修墨理氏 
Hiugi Hala	徐吉氏 
Hiugiya Hala	徐佳氏 
Hiu Hala	徐氏 
Hiu Hala	徐氏 
Hiujala Hala	徐札喇氏 
Hiu Hala	许氏 
Hiuca Hala	叙察氏 
Huan Hala	宣氏 
Hue Hala	薛氏 
Hiuncaol Hala	逊绰尔氏 
Yarhu Hala	雅尔胡氏 
Yarsala Hala	雅尔萨喇氏 
Yagiya Hala	雅佳氏 
Ya Hala	雅氏 
Yasu Hala	雅苏氏 
Yegulite Hala	雅苏氏 
Yan Hala	鄢氏 
Yan Hala	严氏 
Yan Hala	阎氏 
Yangiri Hala	颜济哩氏 
Yangi Hala	颜济氏 
Yan Hala	颜氏 
Yanja Hala	颜扎氏 
Yanju Hala	颜珠氏 
Yangai Hala	扬蔼氏 
Yangeri Hala	扬额理氏 
Yanggi Hala	扬吉氏 
Yanggiya Hala	扬佳氏 
Yangna Hala	杨那氏 
Yang Hala	杨氏 
Yang Hala	杨氏 
Yao Hala	姚氏 
Yaogiya Hala	耀佳氏 
Yehere Hala	叶赫勒氏 
Yehe Hala	叶赫氏 
Yekejong Hala	叶克忠氏 
Yekuri Hala	叶库哩氏 
Yelu Hala	叶禄氏 
Yemle Hala	叶墨勒氏 
Yemu Hala	叶穆氏 
Ye Hala	叶氏 
Ibe Hala	伊伯氏 
Ibucite Hala	伊布齐特氏 
Irgengiolo Hala	伊尔根觉罗氏 
Irha Hala	伊尔哈氏 
Irgiya Hala	伊尔佳氏 
Irkule Hala	伊尔库勒氏 
Ikderi Hala	伊克得里氏 
Ikminga Hala	伊克明安氏 
Ilari Hala	伊拉里氏 
Ilaci Hala	伊拉齐氏 
Ilan Hala	伊喇氏 
Ilrgi Hala	伊勒尔济氏 
Ilemen Hala	伊勒们氏 
Ilmu Hala	伊勒穆氏 
Ili Hala	伊里氏 
Imu Hala	伊穆氏 
Imutu Hala	伊穆图氏 
I Hala	伊氏 
Isu Hala	伊苏氏 
Itum Hala	伊图马氏 
Ijar Hala	伊扎尔氏 
I Hala	宜氏 
Itehe Hala	宜特黑氏 
Itemo Hala	宜特墨氏 
Ingiya Hala	音佳氏 
Iingai Hala	音斋氏 
Iing Hala	尹氏 
Inggiya Hala	英佳氏 
Iongsebu Hala	永舍布氏 
Yongloku Hala	攸络库氏 
Yiokre Hala	尤克热氏 
yio Hala	尤氏 
Yiogeri Hala	猷格理氏 
Yioge Hala	猷格氏 
Yiohulu Hala	佑祜鲁氏 
Yugiya Hala	于佳氏 
Yu Hala	于氏 
Yu Hala	俞氏 
Yugiya Hala	虞佳氏 
Yur Hala	禹尔氏 
Yurkule Hala	玉尔库勒氏 
Yurku Hala	玉尔库氏 
Yukmo Hala	玉克墨氏 
Yukuli Hala	玉库勒氏 
Yulu Hala	玉鲁氏 
Yutumo Hala	玉图墨氏 
Yuhulu Hala	裕瑚鲁氏 
Iuan Hala	袁氏 
Yoca Hala	岳察氏 
Yolocin Hala	岳罗沁氏 
Yonoto Hala	岳诺托氏 
Yo Hala	岳氏 
Jaigiya Hala	载佳氏 
JaHala	扎哈拉氏 
Jahacite Hala	扎哈齐特氏 
Jahasucin Hala	扎哈苏沁氏 
Jakdan Hala	扎克塔氏 
Jaku Hala	扎库氏 
Jakuta Hala	扎库塔氏 
Jalari Hala	扎拉里氏 
Jala Hala	扎拉氏 
Jalai Hala	扎赖氏 
Jarite Hala	扎哩特氏 
Jaluca Hala	扎鲁察氏 
Jalute Hala	扎鲁特氏 
Jamtai Hala	扎木泰氏 
Jalute Hala	扎穆尔氏 
Jaluken Hala	扎穆恳氏 
Jamya Hala	扎穆雅氏 
Jatehe Hala	扎特黑氏 
Jahama Hala	札哈玛氏 
Jalar Hala	札拉尔氏 
Jasihuri Hala	札思瑚哩氏 
Jasuri Hala	札苏哩氏 
Jayajala Hala	札雅札喇氏 
Jancuhun Hala	瞻楚浑氏 
Janni Hala	占尼氏 
Janggiya Hala	张佳氏 
Jang Hala	张氏 
Jang Hala	张氏 
Janggiya Hala	章佳氏 
Jangmu Hala	章穆氏 
Jangci Hala	章齐氏 
Jang Hala	章氏 
Jangturi Hala	章图理氏 
Jangjal Hala	彰扎尔氏 
Jaobal Hala	兆巴尔氏 
Jaodalhan Hala	兆达尔汉氏 
Joogiya Hala	兆佳氏 
Joole Hala	兆垒氏 
Joohite Hala	兆齐特氏 
Joolote Hala	赵罗特氏 
Joo Hala	赵氏 
Jooyute Hala	赵禹特氏 
Joogiya Hala	肇佳氏 
Jebe Hala	哲柏氏 
Jerde Hala	哲尔德氏 
Jergi Hala	哲尔齐氏 
Jerin Hala	哲哩氏 
Jenggiya Hala	郑佳氏 
Jengnelute Hala	郑讷鲁特氏 
Jeng Hala	郑氏 
Jeng Hala	郑氏 
Jonggi Hala	钟吉氏 
Jong Hala	钟氏 
Joceng Hala	周成氏 
Jo Hala	周氏 
Joyan Hala	周延氏 
Jurgen Hala	朱尔根氏 
Jang Hala	朱尔衮氏 
Ju Hala	朱氏 
Juhiri Hala	朱锡哩氏 
Jurgitemoke Hala	珠尔吉特鄂谟克氏 
Jurki Hala	珠尔奇氏 
Jursu Hala	珠尔苏氏 
Jugede Hala	珠格德氏 
Juge Hala	珠格氏 
Juhele Hala	珠赫勒氏 
Jugiya Hala	珠佳氏 
Juru Hala	珠鲁氏 
Juyala Hala	珠雅拉氏 
Juweta Hala	专塔氏 
Juweci Hala	准齐氏 
Juwebalute Hala	卓巴鲁特氏 
Juwedomu Hala	卓多穆氏 
Juwelgute Hala	卓尔古特氏 
Juwelhecin Hala	卓尔和沁氏 
Juwelte Hala	卓尔特氏 
Juwegiya Hala	卓佳氏 
Juwegin Hala	卓晋氏 
Juwekgiya Hala	卓克佳氏 
Juweke Hala	卓克氏 
Juwecibucute Hala	卓齐布楚特氏 
Juweci Hala	卓奇氏 
Juwecisi Hala	卓启斯氏 
Juwete Hala	卓特氏 
Juwehan Hala	卓显氏 
Jonggiya Hala	宗佳氏 
Jong Hala	宗氏 
Jogiya Hala	邹佳氏 
Jo Hala	邹氏 
Jugiya Hala	组佳氏 
Bayara Hala	巴雅拉氏 
Bayan Hala	巴颜氏 
Bayantu Hala	巴颜图氏 
Bayoote Hala	巴岳特氏 
Bayootu Hala	巴岳图氏 
Bai Hala	白氏 
Baiyir Hala	白依尔氏 
Bai Hala	柏氏 
Baica Hala	拜察氏 
Baican Hala	拜禅氏 
Baidar Hala	拜达尔氏 
Baidu Hala	拜都氏 
Baige Hala	拜格氏 
Baigiya Hala	拜佳氏 
Baigiyala Hala	拜嘉拉氏 
Baiji Hala	拜津氏 
Boogi Hala	宝济氏 
Borigit Hala	宝里吉特氏 
Bogiya Hala	保佳氏 
Beltgir Hala	贝尔特吉尔氏 
Beyagir Hala	贝亚吉尔氏 
Birule Hara	必鲁勒氏 
Biladak Hala	毕拉达克氏 
Biriyang Hala	毕力扬氏 
Biru Hala	毕噜氏 
Bilya Hala	弼尔雅氏 
Bila Hala	碧喇氏 
Biangiya Hala	边佳氏 
Bian Hala	边氏 
Bian Hala	边氏 
Biaote Hala	表特氏 
Boljon Hala	波罗军氏 
Boktu Hala	伯克图氏 
Baisu Hala	伯苏氏 
Baisute Hala	伯苏特氏 
Bodisi Hala	博第斯氏 
Bodori Hala	博都哩氏 
Boduote Hala	博多特氏 
Borgun Hala	博尔衮氏 
borhero Hala	博尔和罗氏 
Borgigite Hala	博尔济吉特氏 
Borgigin Hala	博尔济克氏 
Borgi Hala	博尔济氏 
Borgisi Hala	博尔济斯氏 
Borga Hala	博尔克氏 
Bogulote Hala	博尔苏特氏 
Boguloke Hala	博古罗克氏 
Bogulote Hala	博古罗特氏 
Bohoro Hala	博和罗氏 
Bolgirge Hala	博勒济尔格氏 
Borjik Hala	博勒卓克氏 
Bolote Hala	博罗特氏 
Bolo Hala	博络氏 
Bosoo Hala	博硕氏 
Bohite Hala	博希特氏 
Buktu Hala	卜克图氏 
Bulamu Hala	卜拉木氏 
Budala Hala	布达喇氏 
Bulca Hala	布尔察氏 
Burhaci Hala	布尔哈齐氏 
Burhacite Hala	布尔哈齐特氏 
Bulni Hala	布尔尼氏 
Bujilgen Hala	布吉尔根氏 
Bukur Hala	布库尔氏 
Buledurben Hala	布楞都尔本氏 
Bulute Hala	布鲁特氏 
Buni Hala	布尼氏 
Busa Hala	布萨氏 
Busai Hala	布赛氏 
Buhi Hala	布希氏 
Buyamuci Hala	布雅穆齐氏 
Caigiya Hala	蔡佳氏 
Cai Hala	蔡氏 
Canggiya Hala	仓佳氏 
Cangmajir Hala	苍马尔纪氏 
Caogiya Hala	曹佳氏 
Cao Hala	曹氏 
Cao Hala	曹氏 
Caodan Hala	漕丹氏 
Calala Hala	查喇拉氏 
ca Hala	查氏 
Caodan Hala	察哈尔氏 
Cakcin Hala	察克钦氏 
Calagolo Hala	察喇觉罗氏 
Cai Hala	柴氏 
Canggiya Hala	常佳氏 
Alakta Hala	超穆特氏 
Ce Hala	车氏 
Cemgun Hala	彻穆衮氏 
Ceyele Hala	彻叶勒氏 
Cengiya Hala	陈佳氏 
Cen Hala	陈氏 
Cen Hala	陈氏 
Cenggiya Hala	成佳氏 
Cenggi Hala	成尼氏 
Ceng Hala	程氏 
Cengkiyir Hala	橙气依尔氏 
C’ygiya Hala	迟佳氏 
C’ygiya Hala	持嘉氏 
Cogolu Hala	崇果噜氏 
Cojila Hala	崇吉喇氏 
Cukule Hala	楚库勒氏 
Alakta Hala	吹霍克亲氏 
Coki Hala	绰克秦氏 
Colosi Hala	绰罗斯氏 
Cuigiya Hala	崔佳氏 
Cuimulu Hala	崔穆鲁氏 
Cui Hala	崔氏 
Cui Hala	崔氏 
Cuijuke Hala	崔珠克氏 
Dacongga Hala	达尔充阿氏 
Darkun Hala	达尔坤氏 
Dartao Hala	达尔陶氏 
Dalaminan Hala	达喇明安氏 
Dalamu Hala	达喇穆氏 
Dalute Hala	达鲁特氏 
Dalote Hala	达罗克氏 
Daputu Hala	达普图氏 
Dagiya Hala	大佳氏 
Daikite Hala	岱齐特氏 
Daibolo Hala	戴卜罗氏 
Daila Hala	戴拉氏 
Dai Hala	戴氏 
Dedul Hala	德都勒氏 
Dedun Hala	德敦氏 
Detecite Hala	德特齐特氏 
Deng Hala	邓氏 
Diaolo Hala	刁落氏 
Ding Hala	丁氏 
Ding Hala	丁氏 
Dingjiri Hala	定吉哩氏 
Dalote Hala	冬果尔氏 
Donggo Hala	董鄂氏 
Dongkeng Hala	董坑氏 
Dong Hala	董氏 
Dongga Hala	栋阿氏 
Donggiya Hala	栋佳氏 
Durha Hala	都尔哈氏 
Durle Hala	都尔勒氏 
Dugiya Hala	都佳氏 
Dkda Hala	都克达氏 
Dkdari Hala	都克塔理氏 
Dular Hala	都拉尔氏 
Dule Hala	都勒氏 
Duri Hala	都哩氏 
Durun Hala	都噜氏 
Duneheng Hala	都讷亨氏 
Dusan Hala	都善氏 
Duwargiya Hala	都瓦尔佳氏 
Duyar Hala	都雅尔氏 
Dular Hala	杜拉尔氏 
Dunengken Hala	杜能肯氏 
Ducile Hala	杜奇勒氏 
Du Hala	杜氏 
Duan Hala	段氏 
Dorgun Hala	多尔衮氏 
Dortala Hala	多尔塔喇氏 
Dortor Hala	多尔托尔氏 
Dogin Hala	多锦氏 
Doronggo Hala	多罗宏氏 
Dorongke Hala	多罗科氏 
Dolo Hala	多罗氏 
Dohin Hala	多秦氏 
Dohing Hala	多兴氏 
Ecengiya Hala	额陈佳氏 
Erdun Hala	额尔敦氏 
Elgegi Hala	额尔格济氏 
Ergeten Hala	额尔格特恩氏 
Elgetu Hala	额尔格图氏 
Ergonote Hala	额尔果诺特氏 
Elhuiejete Hala	额尔辉额哲特氏 
Ergi Hala	额尔吉氏 
Erkule Hala	额尔库勒氏 
Ertu Hala	额尔图氏 
Ertute Hala	额尔图特氏 
Elhe Hala	额勒赫氏 
Emteli Hala	额穆特立氏 
Enon Hala	额诺氏 
Esi Hala	额色氏 
Esuri Hala	额苏哩氏 
Eyesu Hala	额宜苏氏 
Eyute Hala	额玉特氏 
Ejete Hala	额扎特氏 
Eje Hala	额哲氏 
Eju Hala	额珠氏 
Ejute Hala	额珠特氏 
Ejuo Hala	额卓氏 
Ecolo Hala	鄂绰罗氏 
Engite Hala	鄂恩济特氏 
Elcuolo Hala	鄂尔绰络氏 
Erde Hala	鄂尔格氏 
Erkete Hala	鄂尔克特氏 
Ercin Hala	鄂尔沁氏 
Erte Hala	鄂尔特氏 
Egiri Hala	鄂济哩氏 
Weji Hala	鄂济氏 
Egite Hala	鄂济特氏 
Elaben Hala	鄂拉本氏 
Elakun Hala	鄂拉坤氏 
Erik Hala	鄂礼克氏 
Erimsu Hala	鄂里木苏氏 
Elo Hala	鄂罗氏 
Emte Hala	鄂密特氏 
Emke Hala	鄂谟克氏 
Emto Hala	鄂谟拖氏 
Emucu Hala	鄂木绰氏 
Eci Hala	鄂秦氏 
Esurhu Hala	鄂苏尔瑚氏 
Esolo Hala	鄂索罗氏 
Etuhun Hala	鄂通氏 
Etu Hala	鄂托氏 
Eye Hala	鄂岳氏 
Fangiya Hala	范佳氏 
Fan Hala	范氏 
Fanggiya Hala	方佳氏 
Fang Hala	方氏 
Fang Hala	方氏 
Fang Hala	房氏 
Hongo Hala	洪鄂氏 
Honggon Hala	洪衮氏 
Honggoci Hala	洪果奇氏 
Honggiri Hala	洪吉哩氏 
Honggiya Hala	洪佳氏 
Honglo Hala	洪骆氏 
Hong Hala	洪氏 
Hong Hala	洪氏 
Hongyiri Hala	洪伊理氏 
Honggolo Hala	鸿果络氏 
Hougiya Hala	侯佳氏 
Houg Hala	侯氏 
Hulegiolo Hala	呼伦觉罗氏 
Hugiya Hala	胡佳氏 
Hu Hala	胡氏 
Huhihar Hala	胡西哈尔氏 
Huhi	胡锡氏 
Hudel Hala	瑚德勒氏 
Huding Hala	瑚鼎氏 
Hurga Hala	瑚尔噶氏 
Hurhanla Hala	瑚尔哈喇氏 
Hurhan Hala	瑚尔哈氏 
Hulhasu Hala	瑚尔哈苏氏 
Hurhan Hala	瑚尔汉氏 
Hurhun Hala	瑚尔浑氏 
Hulgiya Hala	瑚尔佳氏 
Hurkul Hala	瑚尔库尔氏 
Hurlasi Hala	瑚尔拉斯氏 
Hultai Hala	瑚尔泰氏 
Huhu Hala	瑚呼氏 
Her Hala	瑚克锡勒氏 
Hukhile Hala	瑚克锡勒氏 
Hulbasi Hala	瑚拉巴斯氏 
Huru Hala	瑚噜氏 
Huruk Hala	瑚鲁克氏 
Huta Hala	瑚塔氏 
Huturi Hala	瑚图哩氏 
Hutu Hala	瑚图氏 
Huhihari Hala	瑚锡哈理氏 
Huhiga Hala	瑚锡喀氏 
Huhiri Hala	瑚锡哩氏 
Husun Hala	瑚逊氏 
Huyala Hala	瑚雅拉氏 
Huya Hala	瑚雅氏 
Huyuru Hala	瑚玉鲁氏 
Huyaolo Hala	瑚岳罗氏 
Huahihari Hala	华西哈里氏 
Huanggutai Hala	黄古台氏 
Huanggiya Hala	黄佳氏 
Huang Hala	黄氏 
Huang Hala	黄氏 
Hundaci Hala	珲达奇氏 
Hunhe Hala	辉和氏 
Hunlo Hala	辉罗氏 
Huotolo Hala	霍托罗氏 
Gi Hala	姬氏 
Gibucu Hala	吉布褚氏 
Girbis Hala	吉尔必斯氏 
Girgi Hala	吉尔吉氏 
Girgiwark Hala	吉尔吉瓦尔喀氏 
Girmen Hala	吉尔门氏 
Gilate Hala	吉喇特氏 
Giritu Hala	吉礼图氏 
Giru Hala	吉噜氏 
Gigiya Hala	纪佳氏 
Giri Hala	纪里氏 
Gi Hala	纪氏 
Gilala Hala	济拉喇氏 
Gilaminemate Hala	济喇敏鄂玛特氏 
Gilute Hala	济鲁特氏 
Giyagiri Hala	佳吉理氏 
Giyabtala Hala	嘉布塔喇氏 
Giyahama Hala	嘉哈玛氏 
Giyagiya Hala	嘉佳氏 
Giyamhu Hala	嘉穆呼氏 
Giyamhugiolo Hala	嘉穆瑚觉罗氏 
Giyajan Hala	嘉瞻氏 
giagiya Hala	贾佳氏 
gia Hala	贾氏 
Giya Hala	假氏 
Giyanggi Hala	江吉氏 
Giyang Hala	江氏 
Giyang Hala	江氏 
Giyanggiya Hala	姜佳氏 
Giyang Hala	姜氏 
Giyanggiya Hala	蒋佳氏 
Giyang Hala	蒋氏 
giao Hala	焦氏 
Gingiya Hala	金佳氏 
Ginmte Hala	金米特氏 
Gin Hala	金氏 
Gin Hala	金氏 
Gin Hala	晋氏 
Gin Hala	靳氏 
Ginggeri Hala	精格理氏 
Ginggigi Hala	精吉集氏 
Ginggi Hala	精吉氏 
Ging Hala	井氏 
Ginggiya Hala	景佳氏 
Giocan Hala	觉禅氏 
Giorca Hala	觉尔察氏 
Giogiya Hala	觉佳氏 
Giolocan Hala	觉罗禅氏 
Kacute Hala	喀楚特氏 
Kalja Hala	喀尔佳氏 
Karku Hala	喀尔库氏 
Karlaha Hala	喀尔拉哈氏 
Kara Hala	喀尔拉氏 
Karnote Hala	喀尔诺特氏 
Kaksiri Hala	喀克锡理氏 
Gala Hala	喀喇氏 
KaRdasu Hala	喀勒达苏氏 
Kasikateng Hala	喀什喀腾氏 
Kartagil Hala	卡尔他吉尔氏 
Kageyir Hala	卡格依尔氏 
Kailun Hala	凯隆氏 
Kaiyan Hala	恺颜氏 
Kanggin Hala	康锦氏 
Kang Hala	康氏 
Kang Hala	康氏 
Kanghiri Hala	康锡哩氏 
Kanggili Hala	康仪理氏 
Kanggeda Hala	慷杰达氏 
Kerteyir Hala	柯尔特依尔氏 
Keben Hala	科本氏 
Kersun Hala	科尔逊氏 
Kekiri Hala	科奇哩氏 
Kete Hala	科特氏 
Kerde Hala	克尔德氏 
Kelede Hala	克勒德氏 
Kele Hala	克勒氏 
Kerite Hala	克哩特氏 
Kelote Hala	克罗特氏 
Kemcu Hala	克穆楚氏 
Kemcute Hala	克穆楚特氏 
Kemhite Hala	克穆齐特氏 
Keyele Hala	克叶勒氏 
Keykele Hala	克伊克勒氏 
Konggolo Hala	崆果罗氏 
Kongkeri Hala	崆克礼氏 
Kongnila Hala	孔尼喇氏 
Kong Hala	孔氏 
Kode Hala	叩德氏 
Kodai Hala	扣岱氏 
Koken Hala	扣恳氏 
Kubuke Hala	库布克氏 
Kublu Hala	库布鲁氏 
Kubute Hala	库布特氏 
Kumtu Hala	库穆图氏 
Kuyala Hala	库雅拉氏 
Kuwalda Hala	夸尔达氏 
Kuicelik Hala	奎车里克氏 
Kuigiya Hala	奎佳氏 
Kuilong Hala	揆龙氏 
Kundule Hala	琨都勒氏 
Koocoli Hala	阔绰里氏 
Kookituri Hala	阔齐图里氏 
Lakule Hala	拉库勒氏 
Layan Hala	拉颜氏 
Laimo Hala	来默氏 
Laibu Hala	赖布氏 
Lai Hala	赖氏 
Langgiya Hala	郎佳氏 
Lang Hala	郎氏 
Lao Hala	劳氏 
Laogo Hala	老沟氏 
Leli Hala	勒第氏 
Lei Hala	雷氏 
Lengbrci Hala	楞布尔勤氏 
Ligiya Hala	李佳氏 
Li Hala	李氏 
Li Hala	李氏 
Litari Hala	理塔哩氏 
Lianggiya Hala	良佳氏 
Liang Hala	梁氏 
Lingiya Hala	林佳氏 
Lin Hala	林氏 
Lin Hala	林氏 
Lin Hala	刘氏 
Lin Hala	刘氏 
Linggirl Hala	留济理氏 
Lingiya Hala	留佳氏 
Long Hala	龙氏 
Luhoru Hala	卢火如氏 
Lu Hala	卢氏 
Lubri Hala	鲁布哩氏 
Lu Hala	鲁氏 
Luhoru Hala	陆火如氏 
Lu Hala	陆氏 
Liyu Hala	吕氏 
Loca Hala	罗察氏 
Logiya Hala	罗佳氏 
Lo Hala	罗氏 
Loye Hala	罗岳氏 
Maldan Hala	马尔丹氏 
Malgite Hala	马尔吉特氏 
Magite Hala	马吉特氏 
Magiya Hala	马佳氏 
Ma Hala	马氏 
Maltun Hala	玛尔屯氏 
Magus Hala	玛古思氏 
Mahayir Hala	玛哈依尔氏 
Malakul Hala	玛拉库尔氏 
Malayir Hala	玛拉依尔氏 
Malala Hala	玛喇拉氏 
Malanga Hala	玛朗阿氏 
Majak Hala	玛扎克氏 
Manjin Hala	满津氏 
Manja Hala	满扎氏 
Manggenute Hala	莽格努特氏 
Manggo Hala	莽果氏 
Manggico Hala	莽吉绰氏 
Manggiya Hala	莽佳氏 
mengnate Hala	莽那特氏 
Mangnute Hala	莽努特氏 
Maoyi Hala	茂仪氏 
Meiheri Hala	梅赫哩氏 
Meigiya Hala	梅佳氏 
Meiren Hala	梅勒氏 
Meileng Hala	梅楞氏 
Mei Hala	梅氏 
Menggiya Hala	盟佳氏 
Menggro Hala	蒙鄂罗氏 
Monggoso Hala	蒙鄂索氏 
Menggucu Hala	蒙古楚氏 
Menggugi Hala	蒙古尔济氏 
Monggori Hala	蒙古里氏 
Malgite Hala	蒙古氏 
Monggo Hala	蒙果氏 
Menggosi Hala	蒙果资氏 
Menggiya Hala	孟佳氏 
Mengkyiri Hala	孟克宜勒氏 
Meng Hala	孟氏 
Meng Hala	孟氏 
Migiya Hala	米佳氏 
Mija Hala	密札氏 
Min Hala	苗氏 
Miao Hala	闵氏 
Min Hala	闵氏 
Minggan Hala	明安氏 
Molociri Hala	谟勒齐哩氏 
Moto Hala	谟托氏 
Malgite Hala	谟锡勒氏 
Molo Hala	谟岳罗氏 
Lu Hala	莫氏 
Mordaja Hala	墨尔达札氏 
Mordan Hala	墨尔丹氏 
mordi Hala	墨尔迪氏 
Morho Hala	墨尔赫氏 
Morgi Hala	墨尔吉氏 
Morgigite Hala	墨尔济吉特氏 
Morgi Hala	墨尔齐氏 
Morcite Hala	墨尔乞特氏 
Morcin Hala	墨尔秦氏 
Morjel Hala	墨尔哲勒氏 
Mohuri Hala	墨呼哩氏 
Mogiya Hala	墨佳氏 
Mokle Hala	墨克勒氏 
Mokting Hala	墨克廷氏 
Molci Hala	墨勒齐氏 
Mole Hala	墨勒氏 
Morjel Hala	墨勒哲勒氏 
Moneher Hala	默讷赫尔氏 
Mukderi Hala	木克得立氏 
Mu Hala	牧氏 
Muca Hala	穆察氏 
Mudaci Hala	穆达齐氏 
Murca Hala	穆尔察氏 
Muherin Hala	穆和林氏 
Mugiya Hala	穆佳氏 
Muktu Hala	穆克图氏 
Mulde Hala	穆勒德氏 
Mulu Hala	穆鲁氏 
Muci Hala	穆齐氏 
Musen Hala	穆色辰氏 
Mu Hala	穆氏 
Muya Hala	穆雅氏 
Muyan Hala	穆燕氏 
Nahamiguuwata Hala	那哈密瓜塔氏 
Nakta Hala	那克塔氏 
Nalgiya Hala	那勒加氏 
Namudulu Hala	那木都鲁氏 
Namutu Hala	那木图氏 
Nahata Hala	纳哈塔氏 
Nara Hala	纳喇氏 
Nalai Hala	纳赖氏 
Nata Hala	纳塔氏 
Naya Hala	纳雅氏 
Nayi Hala	纳伊氏 
Naiman Hala	奈曼氏 
Naihiri Hala	奈奇里氏 
Naihite Hala	鼐奇特氏 
Nanfulu Hala	南福禄氏 
Nanggiya Hala	囊佳氏 
Nanggiyate Hala	囊嘉特氏 
Nedi Hala	讷迪氏 
Nere Hala	讷勒氏 
Nigele Hala	尼格勒氏 
Niheri Hala	尼赫理氏 
Nigiya Hala	尼佳氏 
Nila Hala	尼拉氏 
Niri Hala	尼里氏 
Nimaca Hala	尼马察氏 
Nimaha Hala	尼玛哈氏 
Nimaci Hala	尼玛奇氏 
Nimanggi Hala	尼满吉氏 
Nikiri Hala	尼奇哩氏 
Nisa Hala	尼沙氏 
Niciri Hala	尼锡哩氏 
Niangniya Hala	尼阳尼雅氏 
Niyngtu Hala	尼音图氏 
Niyote Hala	尼庸特氏 
Nicuhe Hala	尼珠珲氏 
Ninju Hala	尼珠氏 
Ni Hala	倪氏 
Ninggeri Hala	聂格哩氏 
Ninggiya Hala	聂佳氏 
Ning Hala	聂氏 
Ningguta Hala	宁古塔氏 
Ninggiya Hala	宁佳氏 
Ning Hala	宁氏 
Niogiya Hala	牛佳氏 
Nio Hala	牛氏 
Niohele Hala	钮赫勒氏 
Niohe Hala	钮赫氏 
Niohule Hala	钮胡勒氏 
Niohute Hala	钮瑚特氏 
Niohurubu Hala	钮祜禄布氏 
Niohuru Hala	钮祜禄氏 
Nio Hala	钮氏 
Niotu Hala	钮图氏 
Niowanggiyan Hala	钮旺坚氏 
Nioyan Hala	钮颜氏 
Nonggile Hala	农吉勒氏 
Noulte Hala	耨勒特氏 
NonHala	努尔哈拉氏 
Nurhan Hala	努尔汉氏 
Nuru Hala	努鲁氏 
Nolte Hala	诺勒特氏 
Noro Hala	诺罗氏 
Nan Hala	潘氏 
Panggiya Hala	庞佳氏 
Pang Hala	庞氏 
Peigiya Hala	培佳氏 
Pei Hala	裴氏 
Peng Hala	彭氏 
Piaogiya Hala	飘佳氏 
Po Hala	坡氏 
Pogiya Hala	颇佳氏 
Piaogiya Hala	朴佳氏 
Piao Hala	朴氏 
Piao Hala	朴氏 
Pugiya Hala	普佳氏 
Ci Hala	戚氏 
Ci Hala	祁氏 
Cibgio Hala	齐步樵氏 
Cidal Hala	齐达勒氏 
Cirbsu Hala	齐尔博苏氏 
Cigiya Hala	齐佳氏 
Cikten Hala	齐克腾氏 
Cimo Hala	齐墨氏 
Cimsi Hala	齐墨斯氏 
Cimte Hala	齐默特氏 
Cimketu Hala	齐木克图氏 
Cimke Hala	齐穆克氏 
Cipunute Hala	齐普楚特氏 
Cipucite Hala	齐普齐特氏 
Cipucinute Hala	齐普钦努特氏 
Ciyegamte Hala	齐岳噶穆特氏 
Cideri Hala	奇德哩氏 
Cidumu Hala	奇杜穆氏 
Cirgote Hala	奇尔果特氏 
Cilei Hala	奇垒氏 
Cileng Hala	奇楞氏 
Citela Hala	奇塔喇氏 
Ciyala Hala	恰喇氏 
Ciyate Hala	洽特氏 
Ciangiya Hala	钱佳氏 
Cian Hala	钱氏 
Ciyarya Hala	强尔雅氏 
Ciyahiri Hala	强恰理氏 
Ciya Hala	强氏 
Ciaogiya Hala	乔佳氏 
Ciao Hala	乔氏 
Cin Hala	秦氏 
Cingeri Hala	庆格哩氏 
Ciog Hala	邱氏 
Ciogiya Hala	秋佳氏 
Ciog Hala	秋氏 
Ciosuri Hala	秋舒哩氏 
Ciu Hala	曲氏 
Ciugiya Hala	屈佳氏 
Ciu Hala	屈氏 
Ciwangiya Hala	全佳氏 
Iingiya Hala	仁佳氏 
Iin Hala	任氏 
Iing Hala	任氏 
Iing Hala	任氏 
Inde Hala	润德氏 
Samagir Hala	撒玛吉尔氏 
Saca Hala	萨察氏 
Sardu Hala	萨尔都氏 
Saetuke Hala	萨尔图克氏 
Sartu Hala	萨尔图氏 
Sahagiri Hala	萨哈尔察氏 
Sahalgi Hala	萨哈勒济氏 
Sahalian Hala	萨哈连氏 
Sagiala Hala	萨加拉氏 
Sakca Hala	萨克察氏 
Sakda Hala	萨克达氏 
Salatak Hala	萨拉塔克氏 
Salatjo Hala	萨拉特卓氏 
Salatu Hala	萨喇图氏 
Saljute Hala	萨勒珠特氏 
Sarute Hala	萨噜特氏 
Samargi Hala	萨玛尔吉氏 
Samala Hala	萨玛喇氏 
Samhir Hala	萨穆希尔氏 
Saiheri Hala	塞赫理氏 
Saiktu Hala	塞克图氏 
Sailgi Hala	塞楞吉氏 
Saimil Hala	赛密勒氏 
Saiynsartu Hala	赛音萨尔图氏 
Sece Hala	色彻氏 
Selekje Hala	色勒杰氏 
Selri Hala	色勒哩氏 
Semukiri Hala	色穆奇理氏 
Sacahai Hala	沙查海氏 
Sadala Hala	沙达喇氏 
Sala Hala	沙拉氏 
Salatuluteng Hala	沙喇图鲁腾氏 
Sayaote Hala	沙岳特氏 
Sanggiya Hala	商佳氏 
Sang Hala	商氏 
Sang Hala	尚氏 
Seyen Hala	舍颜氏 
Sengiya Hala	申佳氏 
Senmri Hala	申穆哩氏 
Sen Hala	沈氏 
Sen Hala	沈氏 
Senggiya Hala	盛佳氏 
Si Hala	施氏 
Sifuca Hala	石富察氏 
Sigiya Hala	石佳氏 
Siml Hala	石穆鲁氏 
Si Hala	石氏 
Si Hala	时氏 
Siboocan Hala	实宝禅氏 
Si Hala	史氏 
Silu Hala	式勒氏 
So Hala	受氏 
Sumala Hala	书玛哩氏 
Surdu Hala	舒尔都氏 
Sufaca Hala	舒发察氏 
Sugiya Hala	舒佳氏 
Sukduri Hala	舒克都哩氏 
Suru Hala	舒禄氏 
Sumri Hala	舒墨哩氏 
Sumul Hala	舒穆尔氏 
Sumuri Hala	舒穆哩氏 
Sumuru Hala	舒穆禄氏 
Susangiolo Hala	舒善觉罗氏 
Susugiolo Hala	舒舒觉罗氏 
Sunburu Hala	顺布噜氏 
Sigiya Hala	司佳氏 
Sunggi Hala	松吉氏 
Sung Hala	松氏 
hetumbumbi	度H 
ISH	青素缎 
Hacihiyan　　　　　　 哈齐现　　　　　　　 勉力、黾勉　 
Hafun　　　　　　　　 哈梵　　　　　　　　 泰(易卦)　 
Hafungga　　　　　　　哈丰阿　　　　　　　 亨(元亨利贞之亨) 
Haihu　　　　　　　　 哈宜呼　　　　　　　 袅娜多姿　 
Hajilambi　　　　　　 哈季兰比　　　　　　 亲密、亲爱　 
Hajilan　　　　　　　 哈季兰　　　　　　　 亲爱之情　 
HaksabaTugi　　　　　 哈克萨哈东基　　　　 彩霞　 
HalhunEdun　　　　　　哈尔额敦　　　　　　 暖风、熏风　 
HanjaBolgo　　　　　　罕札博勒果　　　　　 忠清廉洁　 
Hiyebele　　　　　　　谢伯乐　　　　　　　 鹞鹰　 
Hiyoosungga　　　　　 豪嵩阿　　　　　　　 至孝之人　 
HocikonIlha　　　　　 和其坤宜尔哈　　　　 姿容俊秀　 
HojonIlha　　　　　　 和准宜尔哈　　　　　 虞美人花　 
Hojo　　　　　　　　　和卓　　　　　　　　 姿容俏丽　 
Hurugan　　　　　　　 呼鲁甘　　　　　　　 玳瑁　 
Huru　　　　　　　　　呼卢　　　　　　　　 高阜，丘陵　 
Hvba　　　　　　　　　呼巴　　　　　　　　 琥珀　 
HojiriIlha　　　　　　和吉里宜尔哈　　　　 美人菊　 
Hvturi　　　　　　　　瑚图里　　　　　　　 福、福祉　 
Hvturingga　　　　　　瑚图玲阿　　　　　　 有福之人　 
Hvwangga　　　　　　　晃阿　　　　　　　　 和睦　 
HvturiImiyarabi　　　 瑚图里宜敏比　　　　 万福齐集　 
HvturiIsimbi　　　　　瑚图里宜琛比　　　　 得福、福至了　 
HvturiFengsenJalafun　瑚图里丰生札喇芬　　 福禄寿　 
YebkenHaha　　　　　　页博肯哈哈　　　　　 好汉子　 
Huwekiyembi　　　　　 瑚渥坤比　　　　　　 发奋、奋兴　 
Hada　　　　　　　　　哈达　　　　　　　　 山峰　 
Haidu　　　　　　　　 海都　　　　　　　　 一边正，一边歪　 
Halhan　　　　　　　　哈尔汉　　　　　　　 犁骅　 
Hari　　　　　　　　　哈礼　　　　　　　　 斜眼　 
Hasiri　　　　　　　　哈席里　　　　　　　 茄花色　 
Hatan　　　　　　　　 哈谭　　　　　　　　 暴躁　 
Hecen　　　　　　　　 赫臣　　　　　　　　 城　 
Hedu　　　　　　　　　赫都　　　　　　　　 疥　 
Hele　　　　　　　　　赫勒　　　　　　　　 哑吧　 
Hethe　　　　　　　　 赫特赫　　　　　　　 饰件、家产　 
Hetu　　　　　　　　　赫图　　　　　　　　 横实　 
Heye　　　　　　　　　赫业　　　　　　　　 眼眵　 
Hida　　　　　　　　　席达　　　　　　　　 蒸蓖、竹帘　 
Hife　　　　　　　　　喜福　　　　　　　　 稗子　 
HifeBaksi　　　　　　 希福巴克什　　　　　 稗子学者　 
Hirgen　　　　　　　　希尔根　　　　　　　 水流痕　 
Hiribu　　　　　　　　西里布　　　　　　　 睡熟、忘了　 
Hohori　　　　　　　　和和礼　　　　　　　 耳门　 
HohoriEfu　　　　　　 何和礼额驸　　　　　 耳门姐夫　 
Hokton　　　　　　　　何克屯　　　　　　　 漂儿(打牲器)暖木(树木)　 
Holo　　　　　　　　　和罗　　　　　　　　 虚假、山谷　 
Homin　　　　　　　　 和敏　　　　　　　　 锄头　 
Hontoho　　　　　　　 浑托和　　　　　　　 管领、一半　 
Horontai　　　　　　　和伦泰　　　　　　　 威　 
Hose　　　　　　　　　霍色　　　　　　　　 盒子　 
Hoto　　　　　　　　　和托　　　　　　　　 秃子、葫芦　 
Huhu　　　　　　　　　胡虎　　　　　　　　 酒曲　 
Huju　　　　　　　　　胡住　　　　　　　　 鞘、槽　 
Hutu　　　　　　　　　胡图　　　　　　　　 鬼、丑人　 
Huba　　　　　　　　　胡巴　　　　　　　　 琥珀　 
Hvban　　　　　　　　 胡班　　　　　　　　 圭、笏　 
Hvlan　　　　　　　　 胡兰　　　　　　　　 烟突　 
Hvri　　　　　　　　　胡里　　　　　　　　 松子　 
Hvse　　　　　　　　　胡塞　　　　　　　　 胡子　 
Hvsi　　　　　　　　　胡锡　　　　　　　　 裹　 
Hvsa　　　　　　　　　胡沙　　　　　　　　 葛　 
Hvwaise　　　　　　　 怀色　　　　　　　　 槐树　 
Hvwa i dolo booi dorgici serguwen	院里比屋里凉快。 
Hergen arame bahanambi	会写字。 
Hvdai ba de genefi jaka be udambi	去市场买东西。 
Haha jui i feksihengge hvdun	男孩跑得快。 
Hvturi dergi mederi i gese	福如东海。 
Hvwaliyasun necin be karmambi	保卫和平。 
Hvturi fengxen jalafun urgun	福禄寿喜。 
Simiyan Hoton oci sara?ara ferguwecuke ba	沈阳是旅游胜地。 
Simiyan Hoton Fe Gurung	沈阳故宫。 
[emteli] 親族のないもの, 
[eniye] 生みの母親 
[erki] 親頼み,勝手な，気ままな 
[ferhe] 手足の親指 
[gucu fali-] 親しく交わる,交友を結ぶ。 
[geo] 牛,驢馬などの牝 
[haji] 熱愛,凶作,親愛な,親密な,親しい 
[hajila-] 親密に暮らす,親交を結ぶ,網で挟んで魚を捕らえる 
[hvwaxan] 僧侶,和尚 彼,彼女, 
[joli-] 質に出す,贖う 
[juru niyaman] 両親,父母 
[nergin de] の際に,の機会に 
[niyaman] 父母,両親,親類,心,心臓,草花の芯 
[sadun] 婚姻,婚戚した先の家,親戚 
[too-] 罵る,貶す,悪口を言う 
[ucuri] 機会,際,折 
[wesihule-] 親を尊ぶ,尊重する 
吏部 土人信服親枝土舍承襲 tusy niyalma akdara sai?a hanci ?n ?n de sirabuki 如土官病故後無子孫可以承襲者則於其同族中親近枝派之 滿文 
吏部 土人信服親枝土舍承襲 tusy niyalma akdara sai?a hanci ?n ?n de sirabuki 如土官病故後無子孫可以承襲者則於其同族中親近枝派之 滿文 
吏部 土人信服親枝土舍承襲 tusy niyalma akdara sai?a hanci ?n ?n de sirabuki 如土官病故後無子孫可以承襲者則於其同族中親近枝派之 滿文 