共搜索到词条120个:
Tabenutuk Hala	塔本努图克氏 
Talhunute Hala	塔尔瑚努特氏 
Talbacik Hala	塔喇巴齐克氏 
Tala Hala	塔喇氏 
Tamca Hala	塔穆察氏 
Tatar Hala	塔塔儿氏 
Tatala Hala	塔塔喇氏 
Tatan Hala	塔坦氏 
Taicu Hala	台楚氏 
Taicuru Hala	泰楚鲁氏 
Taicute Hala	泰楚特氏 
Taihute Hala	泰瑚特氏 
Taihinala Hala	泰锡纳喇氏 
Tan Hala	谈氏 
Tanmca Hala	谭木查氏 
Tan Hala	谭氏 
Tankai Hala	坦开氏 
Tang Hala	汤氏 
Tangwu Hala	汤务氏 
Tangda Hala	唐达氏 
Tanggul Hala	唐古尔氏 
Tanggu Hala	唐古氏 
Tanggute Hala	唐古特氏 
Tanggiya Hala	唐佳氏 
Tangni Hala	唐尼氏 
Tang Hala	唐氏 
Tangyan Hala	唐颜氏 
Taogiya Hala	陶佳氏 
Tao Hala	陶氏 
Tergil Hala	特尔吉尔氏 
Taigi Hala	特济氏 
Tiangiya Hala	田佳氏 
Tian Hala	田氏 
Tian Hala	田氏 
Te Hala	铁氏 
Tongala Hala	通阿拉氏 
Tonggosu Hala	通果苏氏 
Tongyangiolo Hala	通颜觉罗氏 
Tongelo Hala	佟鄂络氏 
Tongniyaote Hala	佟尼耀特氏 
Tunggi Hala	佟启氏 
Tungsail Hala	佟赛勒氏 
Tong Hala	佟氏 
Tong Hala	佟氏 
Tubote Hala	图伯特氏 
Turdun Hala	图尔敦氏 
Turgen Hala	图尔格氏 
Turgiya Hala	图尔佳氏 
Turtala Hala	图尔塔喇氏 
Tugiya Hala	图佳氏 
Tukdun Hala	图克敦氏 
Tukcinala Hala	图克齐纳喇氏 
Tukdan Hala	图克坦氏 
Tuleri Hala	图勒哩氏 
Tulolute Hala	图罗鲁特氏 
Tumen Hala	图们氏 
Tupusu Hala	图普苏氏 
Tusala Hala	图萨喇氏 
Tuseri Hala	图色哩氏 
Tu Hala	图氏 
Tu Hala	屠氏 
Tumte Hala	土默特氏 
Toherci Hala	托和尔秦氏 
Tohoro Hala	托和罗氏 
Tolgiya Hala	托勒佳氏 
Toli Hala	托里氏 
Tolote Hala	托罗特氏 
Tomon Hala	托谟氏 
Totek Hala	托忒克氏 
GenggiyenTug　　　　　更甘图吉　　　　　　 青云　 
HaksabaTugi　　　　　 哈克萨哈东基　　　　 彩霞　 
NeoreTugi　　　　　　 钮勒 图吉　　　　　　浮云　 
Tacibu　　　　　　　　塔齐布　　　　　　　 令学　 
Taifin　　　　　　　　泰芬　　　　　　　　 太平　 
Tebcimbi　　　　　　　特博勤比　　　　　　 忍耐　 
Tob　　　　　　　　　 陀博　　　　　　　　 正直、公正　 
Tojin　　　　　　　　 陀瑾　　　　　　　　 孔雀　 
Tondo　　　　　　　　 屯多　　　　　　　　 公正、正直　 
TondoAkdun　　　　　　屯多阿克敦　　　　　 节义、忠信　 
TondoGiljan　　　　　 屯多吉尔占　　　　　 忠恕、公正宽大 
TaktuBaturu　　　　　 他克图巴图鲁　　　　 高栖勇士　 
Talman　　　　　　　　塔尔曼　　　　　　　 雾　 
Tanggvha　　　　　　　唐古哈　　　　　　　 寒鸦　 
Tantu　　　　　　　　 谈图　　　　　　　　 荡头(农具)　 
To　　　　　　　　　　托　　　　　　　　　 记念、一札　 
Toro　　　　　　　　　托罗　　　　　　　　 桃　 
Tubihe　　　　　　　　图弼赫　　　　　　　 果子　 
Tulhun　　　　　　　　图尔浑　　　　　　　 阴　 
Tumen　　　　　　　　 图门　　　　　　　　 万　 
Tura　　　　　　　　　图喇　　　　　　　　 柱　 
Turi　　　　　　　　　图礼　　　　　　　　 豆　 
Tusa　　　　　　　　　图萨　　　　　　　　 利益　 
Mini hala Tung	我姓佟。 
Tere tacikv de genembi	她去学校。 
Tacikv de bithe be hvlambi	在学校里读书。 
Tere be gaju	把那个拿来。 
[amban] 大臣,臣,官員 
[bokson] 弓の一部分,門の閾, 
[cifa-] 壁土や漆喰などを塗る 
[doholo-] 漆喰を塗る,足を掛ける 
[duka] 門 
[eshun] 生の,野生の,未熟な,慣れていない, 
[fajukv] 肛門 
[iju-] 糊?膠を塗る,付ける 
[ijubu-] 塗らせる,付けさせる 
[ijura-] 塗る,付ける 
[jemden] 賄賂などの弊害 
[niyamniya-] 騎射する,馬で走りながら射る 
[oron] 官人の地位,役職,欠員,代役,陰精,辰 
[taciha] 慣れた 
[tacin] 習慣,風俗,学問 
[teru] 肛門 
[yanggila-] からかう，誘惑する，誘う 
[yarkiya-] 誘惑する，誘う，気を引く 
Teki 请坐 [来源 http://sihvsurehan.blog.sohu.com] 
Tere oci hangjeo i ba i niyalma. 他是杭州人。[来源 http://sihvsurehan.blog.sohu.com] 
Tubade 　isinaki. 请到那里去。[来源 http://sihvsurehan.blog.sohu.com] 
吏部 承差 ?ng cai 承辦差務之委員 滿文 
吏部 承差 ?ng cai 承辦差務之委員 滿文 
吏部 承差 ?ng cai 承辦差務之委員 滿文 